{"tiles":"2222222222222222222222222222222222222222222222222222222222222222222222222222222222222222222222222222
2222222222222222222222222222222222222222222222222222222222222222222222222222222222222222222222222222
2222222222222222222222222222222222222222222222222222222222222222222222222222222222222222222222222222
2222222222222222222222222222222222222222222222222222222222222222222222222222222222222222222222222222
2222222000000000000000000000000000000222222222222222222222200000000000000000000000000000002222222222
2222220000000000000000000000000000000000000022222222220000000000000000000000000000000000000222222222
2222200000000000000000000000000000000000000000022200000000000000000000000000000000000000000022222222
2222000000000000000000000000000000000000000000000000000111000000000000000000000000000000000002222222
2222000000000000000000000000000000000000000000000000000000000000000000000000000000000000000002222222
2222000000000000000000000000000000000000000000000000000000000000000000000000000000000000000002222222
2222000000000000000000000000000000000000000000000000000000000000000000000010000000000000000002222222
2222000000000000000000000000000000000000000000000000000000000000000000000000000000000000000002222222
2222200000000000000000000000000000000000000000000000000000000000000000000000000000000000000002222222
2222200000000000000000000110000000000000000000000000000000000000000000000000000000000000000002222222
2222200000000000000000000000000000000000000000000000000000000000000000000000000000000000000002222222
2222220000000000000000000000000000000000000000000000000000000000000000000000000000000000000002222222
2222220000000000000000000000000000000000000000000000000000000000000000000000000000000000000002222222
2222220000000000000000000000000000000000000000000000000000000000000000000000000000000000000002222222
2222220000000000000000000000000000000000000000000000000000000000000000000000000000110000000002222222
2222220000000000000000000000000000000000000000000000000000000000000000000000000000000000000002222222
2222220000000000000000000000000000000000000010000000000000000000000000000000000000000000000002222222
2222200000000000000011100000000000000000000000000100000000000000000000000000000000000000000002222222
2222200000000000000000000000000000000000000000001000000000000000000000000000000000000000000002222222
2222200000000000000000000000000000000000000000111000000000000000000000000000000000000000000002222222
2222200000000000000000000000000000000000000000111110000000000000000000000000000000000000000002222222
2222200000000000000000000000000000000000000001111111000000000000000000000000000000000000000002222222
2222200000000000000000000000000000000000000011111111101000000000000000000000000000000000000002222222
2222220000000000000000000000000000000000000111111111110000000000000000000000000000000000000002222222
2222220000000000000000000000000000000000001111111111111000000000000000000000000000000000000002222222
2222220000000000000000000000000000000001111111111111110000000000000000000000000000000000000022222222
2222220000000000000000000000000000000000111111111111111000000000000000000000000000000000000222222222
2222200000000010000000000000000000000011111111111111111110000000000000000000000000000000000222222222
2222000000000000000000000000000000000111111111111111111111100000000000000000000000000000000022222222
2222000000000000000000000000000000011111111111111111111111111000000000000000000000000000000022222222
2222000000000000000000000000000000000001111111111111111111111100000000001111000000000000000222222222
2222000000000000000000000000000000000111111111111111111111110000000000000010000000000000000222222222
2222000000000000000000000000000000000001111111111111111111100000000000000000000000000000000222222222
2222000000000000000000000000000000000011111111111111111110000000000000000000000000000000000222222222
2222000000000000000000000000000000000000111111111111111100000000000000000000000000000000000022222222
2222000000000000000000000000000000000001111111111111111000000000000000000000000000000000000022222222
2222000000000000000000000000000000000000011111111111111100000000000000000000000000000000000002222222
2222000000000000000000000000111000000000001111111111111111000000000000000000000000000000000002222222
2222000000000000000000000000000000000000011111111111111100000000000000000000000000000000000002222222
2222000000000000000000000000000000000001111111111111111111000000000000000000000000000000000002222222
2222000000000000000000000000000000000111111111111111111111110000000000000000000000000000000002222222
2222000000000000000000000000000000011111111111111111111111111100000000000000000000110000000002222222
2222000000000000000000000000000001111111111111111111111111111111000000000000000000000000000002222222
2222000000000000000000000000000011111111111111111111111111111111100000000000000000000000000002222222
2222000000000000000000000000000111111111111111111111111111111111110000000000000000000000000002222222
2222000000000000000000000000001111111111111111111111111111111111111000000000000000000000000002222222
2222000000000000000000000000000111111111111111111111111111111111110000000000000000000000000002222222
2222000000000000000000000000000011111111111111111111111111111111100000000000000000000000000002222222
2222000000000000000000000000000001111111111111111111111111111111000000000000000000000000000002222222
2222000000000000000000000000000000011111111111111111111111111100000000000000000000000000000002222222
2222000000000000000000000000000000000111111111111111111111110000000000000000000000000000000002222222
2222000000000000000000000000000000000001111111111111111111000000000000000000000000000000000002222222
2222000000000000000000000000000000000000011111111111111111000000000000000000000000000000000002222222
2222000000000000000000000000000000000000111111111111111110000000000000000000000000000000000002222222
2222000000000000000000000000000000000000011111111111111111000000000000000000000000000000000002222222
2222000000000000000000000000000000000000111111111111111110000000000000000000000110000000000002222222
2222000000000000000000000000000000000011111111111111111111100000000000000000000000000000000002222222
2222000000000000000000000000000000000000111111111111111111100000000000000000000000000000000002222222
2222000000000000000000000000000000000011111111111111111110000000000000000000000000000000000022222222
2222000000000000000000000000000000000000111111111111111111100000000000000000000000000000000222222222
2222000000000000000000000000000000000001111111111111111111100000000000000000000000000000000222222222
2222000000000000000000000000000000000000111111111111111111100000000000000000000000000000000222222222
2222000000000000100000000000000000000011111111111111111111110000000000000000000000000000000222222222
2222000000000000000000000000000000000001111111111111111111111000000000000000000000000000000022222222
2222000000000000000000000000000000000111111111111111111111111100000000000000000000000000000022222222
2222000000000000000000000000000000000011111111111111111111110000000000000000000000000000000222222222
2222000000000000000000000000000000000000111111111111111111000000000000000000000000000000000222222222
2222000000000000000000000000000000000000001111111111111110000000000000000000000000000000000222222222
2222000000000000000000000000000000000000000111111111111000000000000000000000000000000000000222222222
2222200000000000000000000000000000000000000011111111100000000000000000000000000000000000000222222222
2222200000000000000000000000000000000000000000111111000000000000000000000000000000000000000222222222
2222200000000000000000000000000000000000000000011110000000000000000000000000000000000100000222222222
2222200000000000000000000000000000000000000000001100000000000000000000000000000000000000000222222222
2222200000000000000000000000000010000000000000001000000000000000000000000000000000000000000022222222
2222220000000000000000000000000000000000000000000000000000000000000000000000000000000000000022222222
2222220000000000000000000000000000000000000000000000000000000000000000000000000000000000000022222222
2222220000000000000000000000000000000000000000000000000000000000000000000000000000000000000002222222
2222220000000000000000000000000000000000000000000000000000000000000000000000000000000000000002222222
2222200000000000000000000000000000000000000000000000000000000000000000000000000000000000000002222222
2222220000000000000000000000000000000000000000000000000000000000000000000000000000000000000002222222
2222220000000000000001000000000000000000000000000000000000000000000000000000000000000000000002222222
2222220000000000000000000000000000000000000000000000000000000000000000000000000000000000000002222222
2222200000000000000000000000000000000000000000000000000000000000000000000000000000000000000002222222
2222200000000000000000000000000000000000000000000000000000000000000000000000000000000000000002222222
2222200000000000000000000000000000000000000000000000000000000000000000000000000000000000000002222222
2222200000000000000000000000000000000000000000000000000000000000000000000000000000000000000002222222
2222200000000000000000000000000000000000000000000000000000000000000000000000000000000000000022222222
2222220000000000000000000000000000000000000000000000000000000000000000000000000000000000000222222222
2222222000000000000000000000000000000000000000000000000000000000000000000000000000000000002222222222
2222222222222222222222222222222222222222222222222222222222222222222222222222222222222222222222222222
2222222222222222222222222222222222222222222222222222222222222222222222222222222222222222222222222222
2222222222222222222222222222222222222222222222222222222222222222222222222222222222222222222222222222
2222222222222222222222222222222222222222222222222222222222222222222222222222222222222222222222222222
2222222222222222222222222222222222222222222222222222222222222222222222222222222222222222222222222222
2222222222222222222222222222222222222222222222222222222222222222222222222222222222222222222222222222
2222222222222222222222222222222222222222222222222222222222222222222222222222222222222222222222222222" ,
"mapObjects" : [{"type":"tree1", "position":[35,55]},{"type":"tree1", "position":[42,69]},{"type":"tree1", "position":[35,24]},{"type":"tree1", "position":[33,39]}, {"type" : "tree1", "position" : [36, 50]},{"type":"tree1", "position":[62,56]},{"type":"tree1", "position":[60,67]},{"type":"tree1", "position":[58,26]},{"type":"tree1", "position":[65,42]}, {"type" : "tree1", "position" : [66, 49]},{"type":"tree2", "position":[13,90]},{"type":"tree2", "position":[7,71]},{"type":"tree2", "position":[20,38]},{"type":"tree2", "position":[83,75]}],
"palacePlaces" : [[75, 78],[15, 12],[75, 14],[15, 78]] ,
"gameObjects" : []}