{"tiles":"0000000000000000000000000000222222222222222222222222222222222222222222220000000000000000000000000000
0000000000000000000000000000022222222222222222222222222222222222222222200000000000000000000000000000
0000000000000000000000000000002222222222222222222222222222222222222222000000000000000000000000000000
0000000000000000000000000000000222222222222222222222222222222222222220000000000000000000000000000000
0000000000000000000000000000000022222222222222222222222222222222222200000000000000000000000000000000
0000000000000000000000000000000002222222222222222222222222222222222000000000000000000000000000000000
0000000000000000000000000000000000222222222222222222222222222222220000000000000000000000000000000000
0000000000000000000000000000000000022222222222222222222222222222200000000000000000000000000000000000
0000000000000000000000000000000000002222222222222222222222222222000000000000000000000000000000000000
0000000000000000000000000000000000000222222222222222222222222220000000000000000000000000000000000000
0000000000000000000000000000000000000022222222222222222222222200000000000000000000000000000000000000
0000000000000000000000000000000000000002222222222222222222222000000000000000000000000000000000000000
0000000000000000000000000000000000000000222222222222222222220000000000000000000000000000000000000000
0000000000000000000000000000000000000000022222222222222222200000000000000000000000000000000000000000
0000000000000000000000000000000000000000002222222222222222000000000000000000000000000000000000000000
1000000000000000000000000000000000000000000222222222222220000000000000000000000000000000000000000000
1100000000000000000000000000000000000000000022222222222200000000000000000000000000000000000000000000
1110000000000000000000000000000000000000000002222222222000000000000000000000000000000000000000000001
1111100000000000000000000000000000000000000000222222220000000000000000000000000000000000000000000011
1111111000000000000000000000000000000000000000022222200000000000000000000000000000000000000000000111
1111111100000000000000000000000000000000000000002222000000000000000000000000000000000000000000001111
1111111111000000000000000000000000000000000000000220000000000000000000000000000000000000000000011111
1111111111110000000000000000000000000000000000000000000000000000000000000000000000000000000000111111
1111111111111110000000000000000000000000000000000000000000000000000000000000000000000000000001111111
1111111111111111100000000000000000000000000000000000000000000000000000000000000000000000000011111111
1111111111111111110000000000000000000000000000000000000000000000000000000000000000000000000001111111
1111111111111111111000000000000000000000000000000000000000000000000000000000000000000000000000111111
1111111111111111111110000000000000000000000000000000000000000000000000000000000000000000000000011111
1111111111111111111111000000000000000000000000000000000000000000000000000000000000000000000000001111
1111111111111111111111100000000000000000000000000000000000000000000000000000000000000000000000000111
1111111111111111111111000000000000000000000000000000000000000000000000000000000000000000000000000011
1111111111111111111110000000000000000000000000000000000000000000000000000000000000000000000000000001
1111111111111111111000000000000000000000000000000000000000000000000000000000000000000000000000000000
1111111111111111110000000000000000000000000000000000000000000000000000100000000000000000000000000000
1111111111111111100000000000000000000000000000000000000000000000000001110000000000000000000000000000
1111111111111110000000000000000000000000000000000000000000000000000011111000000000000000000000000000
1111111111111000000000000000000000000000000000000000000000000000000001110000000000000000000000000000
1111111111110000000000000000000000000000000000000000000000000000000000100000000000000000000000000000
1111111111000000000000000000000000000000000000222222200000000000000000000000000000000000000000000000
1111111100000000000000000000000000000000000002222222220000000000000000000000000000000000000000000000
1111110000000000000000000000000000000000000022222222222000000000000000000000000000000000000000000000
1111100000000000000000000000000000000000000222222222222200000000000000000000000000000000000000000000
1111000000000000000000000000000000000000002222222222222220000000000000000000000000000000000000000000
1100000000000000000000000000000000000000022222222222222222000000000000000000000000000000000000000000
1000000000000000000000000000000000000000222222222222222222200000000000000000000000000000000000000000
0000000000000000000000000000000000000002222222222222222222220000000000000000000000000000000000000000
0000000000000000000000000000000000000022222222222222222222222000000000000000000000000000000000000000
0000000000000000000000000000000000000222222222222222222222222200000000000000000000000000000000000000
0000000000000000000000000000000000002222222222222222222222222220000000000000000000000000000000000000
0000000000000000000000000000000000022222222222222222222222222222000000000000000000000000000000000000
0000000000000000000000000000000000002222222222222222222222222220000000000000000000000000000000000000
0000000000000000000000000000000000000222222222222222222222222200000000000000000000000000000000000000
0000000000000000000000000000000000000022222222222222222222222000000000000000000000000000000000000000
0000000000000000000000000000000000000002222222222222222222220000000000000000000000000000000000000000
0000000000000000000000000000000000000000222222222222222222200000000000000000000000000000000000000000
0000000000000000000000000000000000000000022222222222222222000000000000000000000000000000000000000000
0000000000000000000000000000000000000000002222222222222220000000000000000000000000000000000000000000
0000000000000000000000000000000000000000000222222222222200000000000000000000000000000000000000000000
0000000000000000010000000000000000000000000022222222222000000000000000000000000000000000000000000000
0000000000000000111000000000000000000000000002222222220000000000000000000000000000000000000000000000
0000000000000001111100000000000000000000000000222222200000000000000000000000000000000000000000000000
0000000000000011111110000000000000000000000000000000000000000000000000000000000000000000000000000000
0000000000000111111111000000000000000000000000000000000000000000000000000000000000000000000000000000
0000000000000011111110000000000000000000000000000000000000000000000000000000000000000000000000000000
0000000000000001111100000000000000000000000000000000000000000000000000000000000000000000000000000000
0000000000000000111000000000000000000000000000000000000000000000000000000000000000000000000000000001
0000000000000000010000000000000000000000000000000000000000000000000000000000000000000000000000000111
0000000000000000000000000000000000000000000000000000000000000000000001100000000000000000000000011111
0000000000000000000000000000000000000000000000000000000000000000000011110000000000000000000000011111
0000000000000000000000000000000000000000000000000000000000000000000111111000000000000000000000011111
0000000000000000000000000000000000000000000000000000000000000000001111111100000000000000000000011111
0000000000000000000000000000000000000000000000000000000000000000000111111000000000000000000000011111
0000000000000000000000000000000000000000000000000000000000000000000011110000000000000000000000000111
0000000000000000000000000000000000000000000000000000000000000000000001100000000000000000000000000111
0000000000000000000000000000000000000000000000000000000000000000000000000000000000000000000000011111
0000000000000000000000000000000000000000000000000000000000000000000000000000000000000000000000111111
0000000000000000000000000000000000000000000000000000000000000000000000000000000000000000000000011111
0000000000000000000000000000000000000000000000000000000000000000000000000000000000000000000000011111
0000000000000000000000000000000000000000000000000220000000000000000000000000000000000000000000011111
0000000000000000000000000000000000000000000000002222000000000000000000000000000000000000000000000111
0000000000000000000000000000000000000000000000022222200000000000000000000000000000000000000000000001
0000000000000000000000000000000000000000000000222222220000000000000000000000000000000000000000000000
0000000000000000000000000000000000000000000002222222222000000000000000000000000000000000000000000000
0000000000000000000000000000000000000000000022222222222200000000000000000000000000000000000000000000
0000000000000000000000000000000000000000000222222222222220000000000000000000000000000000000000000000
0000000000000000000000000000000000000000002222222222222222000000000000000000000000000000000000000000
0000000000000000000000000000000000000000022222222222222222200000000000000000000000000000000000000000
0000000000000000000000000000000000000000222222222222222222220000000000000000000000000000000000000000
0000000000000000000000000000000000000002222222222222222222222000000000000000000000000000000000000000
0000000000000000000000000000000000000022222222222222222222222200000000000000000000000000000000000000
0000000000000000000000000000000000000222222222222222222222222220000000000000000000000000000000000000
0000000000000000000000000000000000002222222222222222222222222222000000000000000000000000000000000000
0000000000000000000000000000000000022222222222222222222222222222200000000000000000000000000000000000
0000000000000000000000000000000000222222222222222222222222222222220000000000000000000000000000000000
0000000000000000000000000000000002222222222222222222222222222222222000000000000000000000000000000000
0000000000000000000000000000000022222222222222222222222222222222222200000000000000000000000000000000
0000000000000000000000000000000222222222222222222222222222222222222220000000000000000000000000000000
0000000000000000000000000000002222222222222222222222222222222222222222000000000000000000000000000000
0000000000000000000000000000022222222222222222222222222222222222222222200000000000000000000000000000
0000000000000000000000000000222222222222222222222222222222222222222222220000000000000000000000000000" ,
"mapObjects" : [{"type":"tree1", "position":[3,3]},{"type":"tree2", "position":[9,10]},{"type":"tree1", "position":[4,80]},{"type":"tree2", "position":[80,80]},{"type":"tree1", "position":[75,57]},{"type":"tree1", "position":[13,46]},{"type":"tree2", "position":[80,6]},{"type":"tree1", "position":[73,9]},{"type":"tree1", "position":[87,39]}],
"palacePlaces" : [[75, 78],[15, 9],[75, 14],[15, 78]] ,
"gameObjects" : []}